music=midi4.mid
18,39,2,2,9,
f,castleDemo,4,0,none,
f,castle3,5,1,Boss Key,
f,20,4000;monster.explode,monster.wolf,
f,20,3000;monster.wolf,
f,0,1,750;monster.arrow,
f,0,1,750;monster.arrow,
f,0,1,750;monster.arrow,
f,0,1,750;monster.arrow,
f,0,1,750;monster.arrow,
f,0,1,375;monster.arrow,
f,0,1,750;monster.arrow,
f,0,1,375;monster.arrow,
f,0,1,750;monster.arrow,
black,
f,f,f,f,f,f,f,f,f,f,f,f,f,f,P,P,P,f,P,P,P,f,P,P,P,f,f,f,f,f,f,f,f,f,f,f,f,f,f,
f,p,f,f,f,p,f,f,f,p,f,f,f,p,f,f,f,p,f,f,f,p,f,f,f,p,f,f,f,p,f,f,f,p,f,f,f,p,f,
f,f,c,f,f,f,f,f,f,f,f,f,f,f,f,f,f,f,f,f,f,f,f,f,f,f,f,f,f,f,f,f,f,f,f,f,c,f,f,
f,f,f,f,f,f,f,f,f,f,f,f,f,f,f,f,f,f,f,f,f,f,f,f,f,f,f,f,f,f,f,f,f,f,f,f,f,f,f,
f,p,f,f,f,f,f,f,f,f,f,f,f,f,f,f,f,f,f,f,f,f,f,f,f,f,f,f,f,f,f,f,f,f,f,f,f,p,f,
f,f,f,f,f,f,f,f,f,f,f,f,f,f,f,f,f,f,f,f,f,f,f,f,f,f,f,f,f,f,f,f,f,f,f,f,f,f,f,
f,f,f,f,f,f,f,f,f,f,f,f,f,f,f,f,f,f,f,f,f,f,f,f,f,f,f,f,f,f,f,f,f,f,f,f,f,f,f,
f,p,f,f,f,f,f,f,f,p,f,f,f,p,f,f,f,p,f,f,f,p,f,f,f,p,f,f,f,p,f,f,f,f,f,f,f,p,f,
f,f,f,f,f,f,f,f,f,f,f,f,f,f,f,f,f,f,f,f,f,f,f,f,f,f,f,f,f,f,f,f,f,f,f,f,f,f,f,
f,f,f,f,f,f,f,f,f,f,f,b,b,b,b,b,b,b,b,b,b,b,b,b,b,b,b,b,f,f,f,f,f,f,f,f,f,f,f,
f,p,f,f,f,f,f,f,f,p,f,b,b,b,b,b,b,b,b,b,b,b,b,b,b,b,b,b,f,p,f,f,f,f,f,f,f,p,f,
f,f,f,f,f,f,f,f,f,f,f,b,b,b,b,b,b,b,b,b,b,b,b,b,b,b,b,b,f,f,f,f,f,f,f,f,f,f,f,
f,f,f,f,f,f,f,f,f,f,f,b,b,b,b,b,b,b,b,b,b,b,b,b,b,b,b,b,f,f,f,f,f,f,f,f,f,f,f,
f,p,f,f,f,f,f,f,f,p,f,b,b,b,b,b,b,b,b,b,b,b,b,b,b,b,b,b,f,p,f,f,f,f,f,f,f,p,f,
f,f,f,f,f,f,f,f,f,f,f,b,b,b,b,b,b,b,b,b,b,b,b,b,b,b,b,b,f,f,f,f,f,f,f,f,f,f,f,
f,f,f,f,f,f,f,f,f,f,f,b,b,b,b,b,b,b,b,b,b,b,b,b,b,b,b,b,f,f,f,f,f,f,f,f,f,f,f,
f,p,f,f,f,m,f,f,f,p,f,b,b,b,b,b,b,b,b,b,b,b,b,b,b,b,b,b,f,p,f,f,f,m,f,f,f,p,f,
f,f,f,f,f,f,f,f,f,f,f,b,b,b,b,b,b,b,b,b,b,b,b,b,b,b,b,b,f,f,f,f,f,f,f,f,f,f,f,