music=midi7.mid
8,11,1,1,0,
f,castleDemo2,34,15,none,
f,1,100;monster.darkKnight,
black,
f,f,f,f,f,m,f,f,f,f,f,
f,p,f,f,f,p,f,f,f,p,f,
f,f,f,f,f,f,f,f,f,f,f,
f,f,f,f,f,f,f,f,f,f,f,
f,p,f,f,f,f,f,f,f,p,f,
f,f,f,f,f,f,f,f,f,f,f,
f,f,f,f,f,c,f,f,f,f,f,
f,p,f,f,f,f,f,f,f,p,f,