music=midi4.mid
8,11,2,0,0,
f,castleDemo2,5,15,Gold Key,
f,Demo5,24,3,none,
black,
f,f,f,f,f,m,f,f,f,f,f,
f,p,f,f,f,p,f,f,f,p,f,
f,f,f,f,f,f,f,f,f,f,f,
f,f,f,f,f,f,f,f,f,f,f,
f,p,f,f,f,f,f,f,f,p,f,
f,f,f,f,f,f,f,f,f,f,f,
f,f,f,f,f,f,f,f,f,f,f,
f,p,f,f,f,m,f,f,f,p,f,