music=midi7.mid
31,11,1,2,0,
f,castleDemo2,33,15,none,
f,1,100;monster.darkKnight,
f,1,100;monster.jasonLink,
black,
b,b,b,b,b,m,b,b,b,b,b,
f,f,f,f,f,f,f,f,f,f,f,
f,p,f,f,f,f,f,f,f,p,f,
f,f,f,f,f,f,f,f,f,f,f,
f,f,f,f,f,f,f,f,f,f,f,
f,p,f,f,f,f,f,f,f,p,f,
f,f,f,f,f,f,f,f,f,f,f,
f,f,f,f,f,f,f,f,f,f,f,
f,p,f,f,f,f,f,f,f,p,f,
f,f,f,f,f,f,f,f,f,f,f,
f,f,f,f,f,c,f,f,f,f,f,
f,p,f,f,f,f,f,f,f,p,f,
f,f,f,f,f,f,f,f,f,f,f,
f,f,f,f,f,f,f,f,f,f,f,
f,p,f,f,f,f,f,f,f,p,f,
f,f,f,f,f,f,f,f,f,f,f,
f,f,f,f,f,f,f,f,f,f,f,
f,p,f,f,f,f,f,f,f,p,f,
f,f,f,f,f,f,f,f,f,f,f,
f,f,f,f,f,f,f,f,f,f,f,
f,p,f,f,f,f,f,f,f,p,f,
f,f,f,f,f,f,f,f,f,f,f,
f,f,f,f,f,f,f,f,f,f,f,
f,p,f,f,f,f,f,f,f,p,f,
f,f,f,f,f,f,f,f,f,f,f,
f,f,f,f,f,f,f,f,f,f,f,
f,p,f,f,f,f,f,f,f,p,f,
f,f,f,f,f,f,f,f,f,f,f,
f,f,f,f,f,c,f,f,f,f,f,
f,p,f,f,f,f,f,f,f,p,f,
f,f,f,f,f,f,f,f,f,f,f,