music=midi2.mid
16,14,1,2,0,
e,Demo2,1,1,none,
g,20,2500;monster.explode,
g,10,2000;passive.passive,
shrub1,
g,g,g,g,g,g,e,e,e,w,w,w,w,w,
g,g,g,g,r,e,e,e,w,w,w,w,w,w,
e,e,e,g,g,g,g,g,e,w,w,w,w,w,
e,e,g,g,g,g,g,g,g,e,w,w,w,w,
e,g,g,g,g,g,e,e,e,g,e,e,w,w,
g,g,e,c,g,g,g,g,g,g,g,e,g,r,
g,g,e,g,g,g,g,e,e,g,g,g,g,g,
g,g,e,e,g,c,e,e,g,g,g,g,e,e,
e,e,e,e,e,g,g,g,g,g,e,e,g,g,
e,e,e,e,e,e,g,g,g,e,e,e,g,g,
e,e,e,e,e,e,e,g,e,T,e,e,g,g,
e,g,e,g,g,g,g,e,e,e,e,g,g,g,
e,e,e,g,g,g,e,r,e,e,g,g,g,g,
e,g,g,g,g,g,e,e,e,g,g,m,g,g,
g,g,g,g,g,g,e,g,g,e,g,g,g,g,
g,g,g,e,g,g,g,g,g,g,g,g,g,g,