music=midi1.mid
16,14,1,2,0,
g,Demo5,1,1,none,
g,5,3000;passive.villagerA,
g,5,3500;passive.villagerB,
shrub1,
e,e,e,e,e,e,e,e,e,e,e,e,e,e,
e,e,e,e,e,e,e,e,e,r,e,e,c,g,
e,r,e,g,g,g,g,g,e,e,e,e,g,g,
e,e,g,g,g,g,g,g,g,e,e,e,g,g,
e,g,g,g,g,g,e,e,e,e,e,e,g,g,
g,g,g,g,g,e,e,e,e,e,g,g,g,g,
g,g,g,r,g,e,e,e,e,g,g,g,g,g,
g,g,g,g,g,c,e,e,g,g,g,g,e,e,
e,g,g,g,g,g,g,g,g,g,e,e,e,e,
e,e,g,g,g,g,g,g,g,e,e,e,g,g,
e,e,e,g,g,g,g,g,e,e,e,e,g,g,
e,T,e,T,g,g,g,e,e,e,e,g,g,g,
g,e,e,e,e,g,e,e,e,e,g,g,g,g,
g,g,e,e,e,e,e,e,e,g,g,m,g,g,
g,g,g,g,g,e,e,g,g,g,g,g,g,g,
g,g,g,g,g,g,g,g,g,g,g,g,g,g,