music=midi6.mid
8,28,3,0,0,
e,Demo4,10,14,none,
g,castleDemo,4,7,Silver Key,
g,Demo1,2,1,none,
shrub1,
e,e,e,e,e,e,e,e,e,e,T,t,T,T,T,T,g,g,g,g,g,b,b,b,b,b,b,b,
e,e,e,e,e,e,e,e,e,r,t,t,g,T,g,g,g,g,g,g,g,b,b,b,b,b,b,b,
e,e,e,g,g,g,g,g,e,e,e,e,T,t,t,T,g,g,g,g,g,b,b,b,C,b,b,b,
m,e,g,g,g,g,g,g,g,e,e,e,T,e,T,t,t,e,g,g,g,g,g,e,e,e,m,g,
e,g,g,g,w,w,g,g,g,g,e,e,e,e,e,e,t,e,e,e,g,g,g,e,e,e,g,g,
g,g,g,w,w,w,w,g,g,g,g,t,T,T,T,e,e,e,e,e,e,e,e,e,e,e,g,g,
g,g,g,g,w,w,g,g,g,g,g,g,T,T,T,T,T,g,g,e,e,e,e,e,e,e,g,g,
g,g,g,g,g,g,g,g,g,g,g,g,g,T,T,T,g,g,g,g,g,g,g,g,g,g,g,g,