music=midi1.mid
8,28,1,2,0,
e,Demo4,1,1,none,
g,5,2000;monster.penguin,
g,5,1500;monster.wolf,monster.healer,
shrub1,
e,e,e,e,e,g,e,e,e,e,e,e,e,e,e,g,g,g,g,g,g,g,g,g,e,e,g,g,
e,e,e,e,e,e,e,e,e,r,e,e,g,g,e,e,g,g,g,r,g,g,g,e,e,e,g,g,
e,e,e,g,g,g,g,g,e,e,e,e,g,g,e,e,e,g,g,g,g,c,e,e,e,e,g,g,
w,w,w,c,g,g,g,g,g,e,e,e,g,g,e,g,e,r,g,g,g,e,e,e,e,g,m,g,
w,w,w,w,w,w,g,e,g,g,e,e,g,g,e,e,e,e,e,g,e,e,T,e,g,g,g,g,
w,w,w,g,g,w,w,g,g,g,g,e,g,g,e,g,e,g,e,e,e,e,e,g,g,g,g,g,
g,g,g,g,g,r,w,w,g,g,g,g,g,g,g,g,g,g,g,g,e,g,g,e,g,g,g,g,
g,g,g,T,g,g,g,w,g,g,g,g,e,e,g,g,g,e,g,g,g,g,g,g,g,g,g,g,