music=midi3.mid
8,35,1,1,0,
g,Demo3,1,1,none,
g,1,100;passive.explain,
shrub1,
e,e,e,e,e,e,e,e,e,e,e,e,e,e,e,g,g,g,g,g,g,g,g,g,e,e,g,g,g,g,g,g,g,g,g,
e,e,e,e,e,e,e,e,e,r,e,e,g,g,e,e,g,g,g,g,g,g,g,e,e,e,g,g,g,g,g,g,g,g,g,
e,e,e,g,g,g,g,g,e,e,E,e,g,g,e,e,e,g,g,g,g,g,e,e,e,e,g,g,g,g,g,g,g,g,g,
e,e,g,g,g,g,g,g,g,e,e,e,g,g,t,e,T,T,T,g,g,e,e,e,e,g,g,g,g,g,e,e,e,g,g,
e,g,g,g,w,w,g,g,c,g,e,e,g,g,e,e,e,e,e,g,e,e,e,e,e,g,g,m,g,g,e,e,e,g,g,
g,g,g,w,w,w,w,g,g,g,g,e,g,g,t,e,T,T,T,e,e,e,e,e,e,g,g,g,g,g,e,e,e,g,g,
g,g,g,g,w,w,w,g,g,g,g,g,g,g,g,g,g,g,g,g,e,g,g,e,e,e,e,e,e,e,e,e,e,g,g,
g,g,g,g,g,g,g,g,g,g,g,g,e,e,g,g,g,e,g,g,g,g,g,g,e,e,e,e,e,e,e,e,e,g,g,