music=midi3.mid
35,45,1,2,0,
e,Map2,1,25,none,
g,1,7000;monster.penguin,
g,1,100;passive.explain,
shrub1,
e,e,e,e,e,e,e,e,e,e,e,e,e,e,e,g,g,g,g,T,g,g,g,g,e,e,g,g,g,T,g,g,g,g,g,g,g,g,g,g,T,T,T,T,T,
e,e,e,e,e,e,e,e,e,r,e,e,g,g,e,e,g,g,g,g,g,g,g,e,e,e,g,g,g,g,g,g,g,T,T,T,g,g,g,g,g,g,g,g,g,
e,e,e,g,g,g,g,g,e,e,E,e,g,g,e,e,e,g,g,g,g,g,e,e,e,e,g,g,g,g,g,g,g,g,g,g,g,g,g,e,e,e,e,e,e,
e,e,g,g,g,g,g,g,g,e,e,e,g,g,t,e,T,T,T,g,g,e,e,e,e,g,g,g,g,g,e,e,e,g,g,e,e,e,e,e,g,g,g,e,e,
e,g,g,w,w,w,g,g,c,g,e,e,g,g,e,e,e,e,e,g,e,e,e,e,e,g,g,t,g,g,e,e,e,e,e,e,g,g,g,g,g,g,g,e,e,
g,g,g,w,w,w,w,g,g,g,e,e,g,g,t,e,T,T,T,e,e,e,e,e,e,g,g,g,g,g,e,e,e,g,g,g,g,g,g,g,g,g,g,e,e,
g,g,g,w,w,w,w,g,g,g,e,g,g,g,g,g,g,g,g,g,e,g,g,e,e,e,e,e,e,e,e,e,e,T,T,T,T,T,T,T,g,g,g,e,e,
g,g,g,g,g,g,g,g,g,e,e,g,g,g,g,g,g,e,g,g,g,g,g,g,e,e,e,e,e,e,e,e,t,T,T,T,T,T,T,T,T,T,T,e,e,
g,g,g,g,g,g,g,e,e,e,e,g,g,g,t,g,t,t,g,g,g,g,g,g,g,g,e,e,g,g,T,T,T,T,T,T,T,T,T,g,g,g,g,e,e,
g,g,g,g,g,g,g,e,e,e,g,g,g,g,t,t,t,t,g,g,g,g,g,g,g,g,e,e,g,g,T,T,T,T,T,T,T,T,T,T,g,g,g,e,e,
g,g,t,g,g,g,g,g,e,e,g,g,g,g,t,t,t,t,g,g,g,g,g,g,g,g,e,e,g,g,T,T,T,T,T,T,T,g,g,e,e,e,e,e,e,
g,g,T,g,g,g,g,g,e,e,g,g,g,g,t,g,g,g,g,g,t,t,t,g,g,T,e,e,g,g,T,T,T,T,T,T,T,g,g,e,e,e,e,e,e,
g,g,g,g,g,g,g,g,e,e,e,e,e,g,g,g,g,g,T,T,T,T,g,g,g,e,e,e,g,g,g,T,T,T,g,g,g,g,e,e,e,e,g,g,g,
T,g,g,g,g,T,g,g,g,g,g,e,e,e,g,g,g,g,T,T,T,t,g,g,g,e,e,e,g,g,g,g,t,T,g,g,e,e,e,e,g,g,g,g,g,
T,T,g,T,g,g,g,g,g,g,g,g,e,e,g,g,g,g,T,T,g,g,g,e,e,e,e,e,g,g,g,g,g,g,g,e,e,e,e,g,g,g,g,g,t,
t,T,t,g,g,g,g,g,g,g,g,g,g,e,g,g,g,g,g,g,g,g,g,e,e,e,e,e,e,e,e,e,e,e,e,e,e,e,g,g,g,g,g,t,t,
T,t,T,T,t,g,g,g,g,g,g,g,g,e,e,g,g,g,g,g,g,g,e,e,e,w,w,e,e,e,e,e,e,e,e,e,e,e,g,g,T,g,g,t,t,
T,T,T,T,T,t,g,g,g,g,g,g,e,e,e,e,e,e,e,e,e,e,e,e,e,w,w,e,e,e,e,g,t,t,g,g,g,g,g,g,g,g,g,t,t,
T,T,T,T,t,T,T,g,g,g,g,g,g,e,e,e,e,e,e,e,e,e,e,e,e,w,g,g,e,e,e,e,t,T,g,g,g,g,g,g,g,g,g,T,T,
g,T,g,T,T,T,T,T,T,g,T,g,g,e,e,e,g,g,g,g,g,g,g,g,w,w,g,g,g,g,e,e,g,g,g,g,g,g,g,g,g,T,T,T,T,
g,g,g,g,t,T,T,T,T,T,T,T,e,e,T,e,e,g,g,T,T,g,g,w,w,w,T,g,g,g,e,e,g,g,g,g,g,g,t,t,T,T,T,T,T,
g,c,g,g,g,g,g,T,T,T,T,e,e,T,T,g,g,g,g,T,T,T,g,w,w,g,g,g,g,g,e,e,g,g,g,g,g,T,T,T,T,T,T,T,T,
g,g,g,t,T,T,g,T,T,T,T,e,e,g,T,g,g,t,g,g,g,g,w,w,w,g,g,g,g,g,e,e,g,g,g,t,t,T,T,T,T,T,T,T,T,
g,g,g,T,T,T,g,T,T,g,e,e,T,T,T,t,g,g,g,g,g,w,w,w,w,g,g,g,g,g,e,e,g,g,t,t,T,T,T,T,T,T,T,T,T,
T,T,T,T,T,T,g,T,g,g,T,T,T,T,T,T,T,t,g,w,w,w,w,w,g,g,g,g,g,g,e,e,e,e,e,e,e,e,e,e,e,e,e,e,e,
g,g,T,T,T,g,g,g,g,T,T,T,T,T,T,T,t,g,g,w,w,w,w,g,g,g,g,g,g,g,e,e,e,e,e,e,e,e,e,e,e,e,e,e,m,
g,g,T,t,T,g,T,T,T,T,T,t,T,T,T,T,T,w,w,w,w,w,w,g,e,e,e,g,g,g,g,t,g,t,t,t,t,T,T,T,T,e,e,e,e,
g,g,T,T,T,g,T,T,T,T,T,T,T,T,T,T,w,w,w,w,w,w,w,e,e,e,e,g,g,g,g,g,g,g,g,g,g,g,g,g,g,T,T,T,T,
g,g,T,T,T,g,t,T,g,t,T,T,T,T,T,w,w,w,w,w,w,w,w,e,e,e,e,e,g,g,w,g,g,g,g,g,g,g,g,g,g,g,g,T,T,
g,g,T,T,T,g,T,T,T,T,T,T,T,T,T,w,w,w,w,w,w,w,w,w,e,e,e,e,e,w,w,w,w,w,w,g,g,g,g,g,g,g,g,g,T,
g,g,T,T,T,g,g,g,g,T,T,t,T,T,T,w,w,w,w,w,w,w,w,w,w,e,w,w,w,w,w,w,w,w,w,w,g,g,g,g,g,g,g,g,g,
g,g,g,T,T,T,T,T,g,T,T,T,T,T,w,w,w,w,w,w,w,w,w,w,w,w,w,w,w,w,w,w,w,w,w,w,w,g,g,g,w,e,e,e,e,
T,T,g,g,T,T,T,g,g,T,T,T,t,w,w,w,w,w,w,w,w,w,w,w,w,w,w,w,w,w,T,T,w,w,w,w,w,w,w,w,w,w,e,e,e,
T,T,T,g,g,T,g,g,T,T,T,T,T,w,w,w,w,w,w,w,w,w,w,w,w,w,w,w,w,T,T,T,T,T,w,w,w,w,w,w,w,w,w,e,e,
T,T,T,T,g,g,g,T,T,T,T,T,T,w,w,w,w,w,w,w,w,w,w,w,w,w,w,w,w,T,T,T,T,T,T,w,w,w,w,w,w,w,w,w,e,