music=midi1.mid
35,45,3,3,0,
e,Map1,43,25,none,
e,Map3,15,1,none,
e,Demo4,1,1,none,
e,5,2000;monster.wolf,
g,3,4000;monster.wolf,
e,5,1500;monster.wolf,monster.healer,
shrub1,
T,T,T,T,T,T,T,T,T,T,T,T,T,T,T,t,T,T,T,T,T,T,T,T,T,T,T,T,T,T,T,T,T,T,T,t,t,t,t,t,t,m,t,t,t,
T,T,T,T,T,T,T,T,T,T,T,T,T,T,t,g,T,T,T,T,T,T,T,T,T,T,T,T,T,T,T,T,T,T,T,g,g,g,g,g,e,e,e,e,t,
T,T,T,T,T,T,T,T,T,T,T,t,g,g,g,g,g,g,g,g,T,T,T,T,T,T,T,T,T,T,t,g,g,g,g,g,g,g,g,e,e,e,e,t,T,
T,T,T,T,t,g,g,g,g,g,g,g,g,g,g,g,e,e,g,g,g,g,g,g,T,T,T,T,T,T,g,g,g,g,g,g,g,g,g,e,e,e,g,t,T,
T,T,T,t,g,g,e,e,e,e,e,e,e,g,g,e,e,e,g,g,g,g,g,g,g,g,t,t,t,g,g,g,g,g,g,g,g,e,e,e,e,g,g,t,T,
T,T,T,g,g,e,e,e,e,e,e,e,e,e,e,e,e,g,g,g,t,t,t,t,t,g,g,g,g,g,g,g,g,g,g,g,e,e,e,g,e,g,g,t,T,
T,T,T,g,g,e,g,g,g,g,g,g,g,e,e,e,g,g,g,g,t,t,t,t,g,g,g,g,g,g,g,g,g,e,e,e,e,e,g,g,e,g,t,T,T,
T,T,T,g,g,e,g,g,T,t,T,g,g,g,e,e,g,g,g,g,g,t,t,t,g,g,g,r,g,g,g,e,e,e,e,e,e,g,g,g,e,g,t,T,T,
T,T,T,g,g,e,g,g,T,t,r,g,g,g,e,e,g,g,g,g,g,g,g,g,g,g,g,g,g,g,g,e,e,e,e,g,g,g,g,g,e,g,t,T,T,
T,T,T,g,g,c,g,g,g,r,g,g,g,g,e,e,e,e,e,e,e,e,e,e,e,e,g,g,g,g,g,e,e,e,g,g,g,g,g,g,e,g,t,T,T,
T,T,T,g,g,g,e,g,g,g,e,g,g,g,e,e,e,e,e,e,e,e,e,e,e,e,e,g,g,g,g,e,e,e,g,g,c,g,g,g,e,g,t,T,T,
T,T,T,g,g,g,e,e,e,e,e,e,e,e,e,g,g,g,g,g,g,g,e,e,e,e,e,e,e,e,e,e,e,e,g,g,g,g,g,g,e,g,t,T,T,
T,T,T,t,g,g,g,e,e,e,e,e,e,e,g,g,T,g,g,g,g,g,g,g,g,e,e,e,e,e,e,e,e,e,g,g,g,g,g,g,e,g,t,T,T,
T,T,T,T,t,g,g,g,g,g,g,g,g,g,g,T,T,T,g,g,g,g,g,g,g,g,g,e,e,e,e,e,e,e,g,g,g,g,e,e,e,g,t,T,T,
T,T,T,T,T,T,T,T,T,T,T,T,T,T,T,T,T,t,t,g,g,g,g,g,r,r,g,e,e,e,e,e,e,e,e,e,e,e,e,e,e,g,t,T,T,
T,T,T,T,T,T,T,T,T,T,T,T,T,T,T,T,T,T,t,t,t,g,g,g,g,g,g,e,e,e,e,e,e,e,e,e,e,e,e,g,g,g,t,T,T,
T,T,T,T,T,T,T,T,T,T,T,T,T,T,T,T,T,T,T,t,t,t,r,g,g,g,g,e,e,e,e,e,e,e,e,g,g,g,g,g,g,T,T,T,T,
T,T,T,T,T,T,T,T,T,T,T,T,T,T,T,T,T,T,T,T,t,t,t,t,g,g,g,e,e,e,e,e,e,g,g,g,g,g,g,g,T,T,T,T,T,
T,T,T,T,T,T,T,T,T,T,T,T,T,T,T,T,T,T,T,T,T,T,T,T,g,g,g,g,e,e,e,e,g,g,g,g,g,g,T,T,T,T,T,T,T,
T,T,T,T,T,T,T,T,T,T,T,T,T,T,T,T,T,T,T,T,T,T,T,T,T,g,g,g,e,e,g,g,g,g,T,T,T,T,T,T,T,T,T,T,T,
T,T,T,T,T,T,T,T,T,T,T,T,T,T,T,T,T,T,T,T,T,T,T,T,g,g,e,e,e,e,g,g,g,T,T,T,T,T,T,T,T,T,T,T,T,
T,T,T,T,T,T,T,T,T,T,T,T,T,T,T,T,T,T,g,g,g,g,g,g,g,e,e,e,e,g,g,T,T,T,T,T,T,T,T,T,T,T,T,T,T,
T,T,T,T,T,T,T,T,T,T,T,T,T,T,T,T,T,g,g,e,e,e,e,e,e,e,e,e,g,g,T,T,T,T,T,T,T,T,T,T,T,T,T,T,T,
T,T,T,T,T,T,T,T,T,T,T,T,T,T,g,g,g,g,e,e,g,g,g,g,T,T,T,T,T,T,T,T,T,T,T,T,T,T,T,T,T,T,T,T,T,
e,e,e,e,e,e,e,e,e,e,e,e,e,e,g,g,g,e,e,g,g,T,T,T,T,T,T,T,T,T,T,T,T,T,T,T,T,T,T,T,T,T,T,T,T,
m,e,e,e,e,e,e,e,e,e,e,e,e,e,e,e,e,e,g,g,g,t,t,t,t,t,t,t,t,t,t,t,t,t,t,t,t,t,t,t,t,t,t,T,T,
e,e,e,e,e,e,e,e,e,e,e,e,e,e,g,g,g,e,e,e,e,g,g,t,t,t,t,g,g,g,g,g,g,g,g,g,g,g,g,g,g,t,t,T,T,
T,T,T,T,T,T,T,T,T,T,T,T,T,T,T,T,T,g,g,g,e,e,g,g,g,g,g,g,g,g,g,g,g,g,e,e,e,e,e,e,g,g,t,T,T,
T,T,T,T,T,T,T,T,T,T,T,T,T,T,T,T,T,T,T,g,g,e,e,e,g,g,g,t,t,t,g,e,e,e,e,e,e,E,E,E,e,e,g,g,T,
T,T,T,T,T,T,T,T,T,T,T,T,T,T,T,T,T,T,T,T,g,e,e,g,g,g,t,t,t,t,t,g,g,g,e,e,e,E,r,E,c,e,g,g,T,
T,T,T,T,T,T,T,T,T,T,T,T,T,r,g,g,g,g,g,g,g,e,e,g,t,t,t,T,T,T,t,t,g,g,g,e,e,E,E,E,e,e,g,g,T,
T,T,T,T,T,T,T,T,T,T,T,T,T,g,g,e,e,e,e,e,e,e,g,t,t,t,t,t,t,T,t,t,g,g,g,g,g,g,e,e,e,e,g,g,T,
g,T,T,T,T,T,T,T,T,T,T,t,t,g,e,e,e,g,g,g,g,g,T,T,T,T,T,T,T,T,T,T,T,T,T,T,T,T,g,g,e,e,g,g,T,
g,g,T,T,T,T,T,T,T,T,T,t,g,g,e,e,e,g,T,T,T,T,T,T,T,T,T,T,T,T,T,T,T,T,T,T,T,g,g,g,g,g,g,T,T,
g,g,T,T,T,T,T,T,t,t,t,t,t,t,t,m,t,T,T,T,T,T,T,T,T,T,T,T,T,T,T,T,T,T,T,T,T,T,T,T,T,T,T,T,T,