music=midi2.mid
45,45,3,0,0,
e,Map4,40,15,none,
e,Map2,15,33,none,
e,Map5,24,11,none,
shrub1,
T,T,T,T,T,T,T,T,T,T,T,T,T,T,t,m,t,T,T,T,T,T,T,T,T,T,T,T,T,T,T,T,T,T,T,t,t,t,t,t,t,t,t,t,t,
T,T,T,T,T,T,T,T,T,T,T,T,T,T,e,e,e,T,T,T,T,T,T,T,T,T,T,T,T,T,T,T,T,T,T,g,g,g,g,g,g,g,e,e,r,
T,T,T,T,T,T,T,T,T,T,T,t,g,e,e,e,e,e,e,g,T,T,T,T,T,T,T,T,T,T,t,g,g,g,g,g,g,g,g,e,e,e,e,e,r,
T,T,T,T,t,T,T,T,T,T,T,T,g,g,e,e,e,e,g,g,g,g,g,g,T,T,T,T,T,T,g,g,g,g,g,g,g,g,e,e,e,e,E,E,r,
T,T,T,t,t,T,T,T,T,T,T,T,g,g,e,e,e,g,g,g,g,g,g,g,g,t,t,t,g,g,g,g,g,g,g,g,e,e,e,e,e,e,E,E,w,
T,T,T,T,T,T,T,T,T,T,T,T,g,g,g,g,g,g,g,g,g,g,g,g,g,g,g,g,g,g,g,g,g,g,e,e,e,e,e,e,e,E,E,w,w,
T,T,T,T,T,T,T,T,T,T,T,g,g,g,g,g,g,g,g,g,g,g,g,g,g,g,g,g,g,g,g,e,e,e,e,e,e,e,e,e,w,w,w,w,w,
T,T,T,T,T,T,T,T,T,T,T,T,g,g,g,g,g,g,g,g,g,g,g,g,g,g,r,g,g,g,e,e,e,e,e,e,e,e,w,w,w,w,w,w,w,
T,T,T,T,T,T,T,T,T,T,T,T,t,g,g,g,g,g,g,g,g,g,g,g,g,g,g,g,g,g,g,e,e,e,e,e,E,w,w,w,w,w,w,w,w,
T,T,T,T,T,T,T,T,T,T,T,T,t,t,g,g,g,g,g,g,g,g,g,e,e,e,g,g,g,g,e,e,e,e,E,w,w,w,w,w,w,w,w,w,w,
T,T,T,T,T,T,T,T,T,T,T,t,t,t,t,t,t,t,t,g,g,g,g,e,e,e,e,e,e,e,e,e,e,w,w,w,w,w,w,w,w,w,w,w,w,
T,T,T,T,T,T,T,T,T,T,T,t,t,t,t,t,t,t,g,g,g,g,g,e,e,e,e,e,e,e,E,E,w,w,w,w,w,w,w,w,w,w,w,w,w,
T,T,T,t,T,T,T,T,T,T,T,T,t,t,T,t,t,g,g,g,g,g,g,g,g,e,e,e,e,e,w,w,w,w,w,w,w,w,w,w,w,w,w,w,w,
T,T,T,T,t,T,T,T,T,T,T,T,T,t,t,T,T,T,g,g,g,g,g,g,g,g,e,e,e,w,w,w,w,w,w,w,w,w,w,w,w,w,w,w,w,
T,T,T,T,T,T,T,T,T,T,T,T,T,T,T,T,T,t,t,g,g,g,g,g,g,g,e,e,E,w,w,w,w,w,w,w,w,w,w,w,w,w,w,w,w,
T,T,T,T,T,T,T,T,T,T,T,T,T,T,T,T,T,T,t,t,t,g,g,g,g,g,e,e,e,e,w,w,w,w,w,w,w,w,w,w,w,w,w,w,w,
T,T,T,T,T,T,T,T,T,T,T,T,T,T,T,T,T,T,T,t,t,t,r,g,g,g,e,e,E,e,e,w,w,w,w,w,w,w,w,w,w,w,w,w,w,
T,T,T,T,T,T,T,T,T,T,T,T,T,T,T,T,T,T,T,T,t,t,t,t,g,g,e,e,E,E,E,w,w,w,w,w,w,w,w,w,w,w,w,w,w,
T,T,T,T,T,T,T,T,T,T,T,T,T,T,T,T,T,T,T,T,T,T,T,T,g,g,g,e,E,E,E,w,w,w,w,w,w,w,w,w,w,w,w,w,w,
T,T,T,T,T,T,T,T,T,T,T,T,T,T,T,T,T,T,T,T,T,T,T,T,T,g,g,e,e,E,E,E,w,w,w,w,w,w,w,w,w,w,w,w,w,
T,T,T,T,T,T,T,T,T,T,T,T,T,T,T,T,T,T,T,T,T,T,T,T,g,g,e,e,e,e,e,e,E,E,w,w,w,w,w,w,w,w,w,w,w,
T,T,T,T,T,T,T,T,T,T,T,T,T,T,T,T,T,T,g,g,g,g,t,T,g,e,e,e,e,e,e,e,E,E,w,w,w,w,w,w,w,w,w,w,w,
T,T,T,T,T,T,T,T,T,T,T,T,T,T,T,T,T,g,g,g,g,g,t,t,e,e,e,e,e,e,e,e,E,w,w,w,w,w,w,w,w,w,w,w,w,
T,T,T,T,T,T,T,T,T,T,T,T,T,T,g,g,g,g,g,g,g,g,T,T,T,T,T,e,e,e,e,E,w,w,w,w,w,w,w,w,w,w,w,w,w,
e,e,t,t,t,t,t,t,t,g,g,g,g,g,g,g,g,g,g,g,g,T,T,T,T,T,T,T,e,e,e,E,w,w,w,w,w,w,w,w,w,w,w,w,w,
m,e,e,t,t,t,t,t,g,g,g,g,g,g,g,g,g,g,g,g,g,t,t,t,t,t,t,t,e,e,e,e,e,w,w,w,w,w,w,w,w,w,w,w,w,
e,e,e,T,t,t,t,g,g,g,g,g,g,g,g,g,g,g,g,g,g,g,g,t,t,t,t,g,e,e,e,e,e,E,w,w,w,w,w,w,w,w,w,w,w,
T,e,e,T,t,t,g,g,g,g,T,T,T,T,T,T,T,g,g,g,g,g,g,g,g,g,g,g,e,e,e,e,E,E,w,w,w,w,w,w,w,w,w,w,w,
T,e,e,T,t,t,g,g,g,T,T,T,T,T,T,T,T,T,T,g,g,g,g,g,g,g,g,g,e,e,e,e,E,w,w,w,w,w,w,w,w,w,w,w,w,
T,e,e,T,T,T,g,g,g,T,T,T,T,T,T,T,T,T,T,T,g,g,g,g,g,g,g,g,e,e,e,e,w,w,w,w,w,w,w,w,w,w,w,w,w,
T,g,g,T,T,T,g,g,T,T,T,T,T,t,t,t,t,t,t,T,g,g,g,g,g,g,g,g,e,e,e,E,w,w,w,w,w,w,w,w,w,w,w,w,w,
T,g,g,g,g,g,g,g,T,T,T,T,T,t,t,t,t,t,T,T,g,g,g,t,e,e,e,e,e,e,e,E,w,w,w,w,w,w,w,w,w,w,w,w,w,
t,g,g,g,g,g,g,g,T,T,T,t,t,t,t,t,t,t,T,T,T,g,e,e,e,e,e,e,e,e,E,w,w,w,w,w,w,w,w,w,w,w,w,w,w,
t,t,T,T,T,T,T,T,T,T,T,t,t,t,t,t,t,t,T,T,T,g,e,e,e,e,e,e,e,E,w,w,w,w,w,w,w,w,w,w,w,w,w,w,w,
t,T,T,T,T,T,T,T,t,t,t,t,t,t,T,T,T,T,T,T,T,r,r,r,m,r,r,r,r,w,w,w,w,w,w,w,w,w,w,w,w,w,w,w,w,
T,T,T,T,T,T,T,T,T,T,T,T,T,T,T,T,T,T,T,T,T,e,e,e,e,e,e,e,e,w,w,w,w,w,w,w,w,w,w,w,w,w,w,w,w,
T,T,T,T,T,T,T,T,T,T,T,T,T,T,T,T,T,T,T,T,T,e,e,e,e,e,e,e,e,e,w,w,w,w,w,w,w,w,w,w,w,w,w,w,w,
T,T,T,T,T,T,T,T,T,T,T,T,T,T,T,T,T,T,T,T,T,e,e,e,e,e,e,e,e,e,w,w,w,w,w,w,w,w,w,w,w,w,w,w,w,
T,T,T,T,T,T,T,T,T,T,T,T,T,T,T,T,T,T,T,T,T,e,e,e,e,e,e,e,e,e,w,w,w,w,w,w,w,w,w,w,w,w,w,w,w,
T,T,T,T,T,T,T,T,T,T,T,T,T,T,T,T,T,T,T,T,T,e,e,e,e,e,e,e,e,e,w,w,w,w,w,w,w,w,w,w,w,w,w,w,w,
T,T,T,T,T,T,T,T,T,T,T,T,T,T,T,T,T,T,T,T,T,e,e,e,e,e,e,e,e,e,w,w,w,w,w,w,w,w,w,w,w,w,w,w,w,
T,T,T,T,T,T,T,T,T,T,T,T,T,T,T,T,T,T,T,T,T,e,e,e,e,e,e,e,e,e,w,w,w,w,w,w,w,w,w,w,w,w,w,w,w,
T,T,T,T,T,T,T,T,T,T,T,T,T,T,T,T,T,T,T,T,T,e,e,e,e,e,e,e,e,e,w,w,w,w,w,w,w,w,w,w,w,w,w,w,w,
T,T,T,T,T,T,T,T,T,T,T,T,T,T,T,T,T,T,T,T,T,e,e,e,e,e,e,e,e,e,w,w,w,w,w,w,w,w,w,w,w,w,w,w,w,
T,T,T,T,T,T,T,T,T,T,T,T,T,T,T,T,T,T,T,T,T,e,e,e,e,e,e,e,e,e,w,w,w,w,w,w,w,w,w,w,w,w,w,w,w,