music=midi7.mid
25,42,1,3,0,
e,Map3,1,25,none,
e,4,2000;monster.wolf,
g,2,1000;monster.wolf,
g,1,2000;monster.wolf,
shrub1,
T,T,T,T,T,T,T,T,T,T,T,T,T,T,T,T,T,T,T,T,T,T,T,T,T,T,T,T,T,T,T,T,T,T,T,T,T,T,T,T,T,T,
T,T,T,T,T,T,T,T,T,T,T,T,T,T,T,T,T,T,T,T,T,T,T,T,T,T,T,T,T,T,T,T,T,T,T,T,T,T,T,T,T,T,
T,T,T,T,T,T,T,T,T,T,T,T,T,T,T,T,T,T,T,T,T,T,T,T,T,T,T,T,T,T,T,T,T,T,T,T,T,T,T,T,T,T,
T,T,T,T,T,T,T,T,T,T,T,T,T,T,T,T,T,T,T,T,T,T,T,T,T,T,T,T,T,T,T,T,T,T,T,T,T,T,T,T,T,T,
T,T,T,T,T,T,T,T,T,T,T,t,t,t,t,T,T,T,T,T,T,T,T,T,T,T,T,T,T,T,T,T,T,T,T,T,T,T,T,T,T,T,
T,T,T,T,T,T,T,T,T,T,T,t,g,g,g,t,T,T,T,T,T,T,T,T,T,T,T,T,T,T,T,T,T,T,T,T,T,T,T,T,T,T,
T,T,T,T,T,T,T,T,T,t,t,g,g,g,g,g,t,t,t,t,T,T,T,T,T,T,T,T,T,T,T,T,T,T,T,T,T,T,T,T,T,T,
T,T,T,T,T,T,T,T,t,g,g,g,g,g,g,g,g,g,g,t,T,T,T,T,T,T,T,T,T,T,t,t,t,t,t,T,T,T,T,T,T,T,
T,T,T,T,T,T,T,t,g,g,g,g,g,g,g,g,g,g,g,t,t,T,T,T,T,T,T,T,t,t,t,g,g,g,g,t,T,T,T,T,T,T,
T,T,T,T,T,T,t,g,g,g,g,e,e,e,g,g,g,g,g,g,t,t,t,t,t,t,t,t,g,g,c,g,g,g,g,t,T,T,T,T,T,T,
T,T,T,T,T,t,g,g,g,g,g,e,r,e,e,g,g,g,g,g,g,g,g,g,g,g,g,g,g,g,g,g,g,g,g,t,T,T,T,T,T,T,
T,T,T,T,t,g,g,g,g,g,g,c,e,e,e,g,g,g,g,g,g,g,g,g,g,g,g,g,g,g,g,g,g,g,g,t,T,T,T,T,T,T,
T,T,T,T,t,g,g,g,g,g,g,g,g,e,e,g,g,g,g,g,g,g,g,g,g,g,g,g,g,g,g,g,g,g,e,t,T,T,T,T,T,T,
T,T,T,T,t,g,g,g,g,g,g,g,g,g,g,g,g,g,g,g,g,g,g,g,g,g,g,g,g,g,g,g,g,g,e,e,t,T,T,T,T,T,
T,T,T,T,t,g,g,g,g,g,g,g,g,g,g,g,g,g,g,g,g,g,g,g,g,g,g,g,g,g,g,g,e,e,e,e,e,e,e,e,e,e,
T,T,T,t,g,g,g,g,g,g,g,g,g,g,g,g,g,g,g,g,g,g,g,g,g,g,g,g,g,g,g,e,e,e,e,e,e,e,e,e,e,m,
T,T,T,t,g,g,g,g,g,g,g,g,g,g,g,g,g,g,g,g,g,g,g,g,g,g,g,g,g,g,g,e,e,e,e,e,e,e,e,e,e,e,
T,T,T,t,g,g,g,g,g,g,g,g,g,g,g,g,g,g,g,g,g,g,g,g,g,g,g,g,g,g,g,e,e,T,T,T,T,T,T,T,T,T,
T,T,T,t,g,g,g,g,g,g,g,g,g,g,g,g,g,g,g,g,g,g,g,g,g,g,g,g,g,g,g,t,T,T,T,T,T,T,T,T,T,T,
T,T,T,T,t,t,g,g,g,g,g,g,g,g,g,g,g,g,g,g,g,g,g,g,g,g,g,g,g,g,t,T,T,T,T,T,T,T,T,T,T,T,
T,T,T,T,T,t,t,t,t,t,g,g,g,g,g,g,g,g,g,g,g,t,t,g,g,g,g,g,g,t,T,T,T,T,T,T,T,T,T,T,T,T,
T,T,T,T,T,T,T,T,T,t,g,g,g,g,c,g,g,g,t,t,t,T,T,t,g,g,g,g,g,t,T,T,T,T,T,T,T,T,T,T,T,T,
T,T,T,T,T,T,T,T,T,T,t,t,t,t,g,g,t,t,T,T,T,T,T,T,t,t,t,t,t,t,T,T,T,T,T,T,T,T,T,T,T,T,
T,T,T,T,T,T,T,T,T,T,T,T,T,T,t,t,T,T,T,T,T,T,T,T,T,T,T,T,T,T,T,T,T,T,T,T,T,T,T,T,T,T,
T,T,T,T,T,T,T,T,T,T,T,T,T,T,T,T,T,T,T,T,T,T,T,T,T,T,T,T,T,T,T,T,T,T,T,T,T,T,T,T,T,T,