music=midi2.mid
20,75,2,0,0,
e,Map3,24,33,none,
e,Map6,5,28,none,
shrub1,
T,T,T,T,T,T,T,T,T,T,T,T,T,T,T,T,T,T,T,T,T,e,e,e,e,e,e,e,e,w,w,w,w,w,w,w,w,w,w,w,w,w,w,w,w,w,w,w,w,w,w,w,w,w,w,w,w,w,w,w,w,w,w,w,w,w,w,w,w,w,w,w,w,w,w,
T,T,T,T,T,T,T,T,T,T,T,T,T,T,T,T,T,T,T,T,T,e,e,e,e,e,e,e,e,e,w,w,w,w,w,w,w,w,w,w,w,w,w,w,w,w,w,w,w,w,w,w,w,w,w,w,w,w,w,w,w,w,w,w,w,w,w,w,w,w,w,w,w,w,w,
T,T,T,T,T,T,T,T,T,T,T,T,T,T,T,T,T,T,T,T,T,e,e,e,e,e,e,e,e,e,w,w,w,w,w,w,w,w,w,w,w,w,w,w,w,w,w,w,w,w,w,w,w,w,w,w,w,w,w,w,w,w,w,w,w,w,w,w,w,w,w,w,w,w,w,
T,T,T,T,T,T,T,T,T,T,T,T,T,T,T,T,T,T,T,T,T,e,e,e,e,e,e,e,e,e,w,w,w,w,w,w,w,w,w,w,w,w,w,w,w,w,w,w,w,w,w,w,w,w,w,w,w,w,w,w,w,w,w,w,w,w,w,w,w,w,w,w,w,w,w,
T,T,T,T,T,T,T,T,T,T,T,T,T,T,T,T,T,T,T,T,T,e,e,e,e,e,e,e,e,e,w,w,w,w,w,w,w,w,w,w,w,w,w,w,w,w,w,w,w,w,w,w,w,w,w,w,w,w,w,w,w,w,w,w,w,w,w,w,w,w,w,w,w,w,w,
T,T,T,T,T,T,T,T,T,T,T,T,T,T,T,T,T,T,T,T,T,e,e,e,e,e,e,e,e,e,w,w,w,w,w,w,w,w,w,w,w,w,w,w,w,w,w,w,w,w,w,w,w,w,w,w,w,w,w,w,w,w,w,w,w,w,w,w,w,w,w,w,w,w,w,
T,T,T,T,T,T,T,T,T,T,T,T,T,T,T,T,T,T,T,T,T,e,e,e,e,e,e,e,e,e,w,w,w,w,w,w,w,w,w,w,w,w,w,w,w,w,w,w,w,w,w,w,w,w,w,w,w,w,w,w,w,w,w,w,w,w,w,w,w,w,w,w,w,w,w,
T,T,T,T,T,T,T,T,T,T,T,T,T,T,T,T,T,T,T,T,T,e,e,e,e,e,e,e,e,e,w,w,w,w,w,w,w,w,w,w,w,w,w,w,w,w,w,w,w,w,w,w,w,w,w,w,w,w,w,w,w,w,w,w,w,w,w,w,w,w,w,w,w,w,w,
T,T,T,T,T,T,T,T,T,T,T,T,T,T,T,T,T,T,T,T,T,e,e,e,e,e,e,e,e,e,w,w,w,w,w,w,w,w,w,w,m,w,w,w,w,w,w,w,w,w,w,w,w,w,w,w,w,w,w,w,w,w,w,w,w,w,w,w,w,w,w,w,w,w,w,
T,T,T,T,T,T,T,T,T,T,T,T,T,T,T,T,T,T,T,T,T,e,e,e,e,e,e,e,e,e,w,w,w,w,w,w,w,w,w,w,e,w,w,w,w,w,w,w,w,w,w,w,w,w,w,w,w,w,w,w,w,w,w,w,w,w,w,w,w,w,w,w,w,w,w,
t,T,T,T,T,T,T,T,t,t,t,t,t,t,T,T,T,T,T,T,T,r,r,r,m,r,r,r,r,w,w,w,w,w,w,w,w,w,w,w,e,w,w,w,w,w,w,w,w,w,w,w,w,w,w,w,w,w,w,w,w,w,w,w,w,w,w,w,w,w,w,w,w,w,w,
T,T,T,T,T,T,T,T,T,T,T,T,T,T,T,T,T,T,T,T,T,e,e,e,e,e,e,e,e,w,w,w,w,w,w,w,w,w,w,w,e,w,w,w,w,w,w,w,w,w,w,w,w,w,w,w,w,w,w,w,w,w,w,w,w,w,w,w,w,w,w,w,w,w,w,
T,T,T,T,T,T,T,T,T,T,T,T,T,T,T,T,T,T,T,T,T,e,e,e,e,e,e,e,e,e,w,w,w,w,w,w,w,w,w,w,e,w,w,w,w,w,w,w,w,w,w,w,w,w,w,w,w,w,w,w,w,w,w,w,w,w,w,w,w,w,w,w,w,w,w,
T,T,T,T,T,T,T,T,T,T,T,T,T,T,T,T,T,T,T,T,T,e,e,e,e,e,e,e,e,e,e,e,w,w,w,w,w,w,w,w,e,w,w,w,w,w,w,w,w,w,w,w,w,w,w,w,w,w,w,w,w,w,w,w,w,w,w,w,w,w,w,w,w,w,w,
T,T,T,T,T,T,T,T,T,T,T,T,T,T,T,T,T,T,T,T,T,e,e,e,e,e,e,e,e,e,e,e,w,w,w,w,w,w,w,w,e,w,w,w,w,w,w,w,w,w,w,w,w,w,w,w,w,w,w,w,w,w,w,w,w,w,w,w,w,w,w,w,w,w,w,
T,T,T,T,T,T,T,T,T,T,T,T,T,T,T,T,T,T,T,T,T,t,e,e,e,e,e,e,e,e,e,e,e,w,w,w,w,w,w,w,e,w,w,w,w,w,w,w,w,w,w,w,w,w,w,w,w,w,w,w,w,w,w,w,w,w,w,w,w,w,w,w,w,w,w,
T,T,T,T,T,T,T,T,T,T,T,T,T,T,T,T,T,T,T,T,T,t,e,e,e,e,e,e,e,e,e,e,e,e,e,e,e,e,e,e,e,e,w,w,w,w,w,w,w,w,w,w,w,w,w,w,w,w,w,w,w,w,w,w,w,w,w,w,w,w,w,w,w,w,w,
T,T,T,T,T,T,T,T,T,T,T,T,T,T,T,T,T,T,T,T,T,T,t,e,e,e,e,e,e,e,e,e,e,e,e,e,e,e,e,e,e,e,w,w,w,w,w,w,w,w,w,w,w,w,w,w,w,w,w,w,w,w,w,w,w,w,w,w,w,w,w,w,w,w,w,
T,T,T,T,T,T,T,T,T,T,T,T,T,T,T,T,T,T,T,T,T,t,t,t,e,e,e,e,e,e,e,e,g,g,g,g,g,g,g,g,e,e,e,w,w,w,w,w,w,w,w,w,w,w,w,w,w,w,w,w,w,w,w,w,w,w,w,w,w,w,w,w,w,w,w,
T,T,T,T,T,T,T,T,T,T,T,T,T,T,T,T,T,T,T,T,T,T,T,t,t,t,e,e,e,e,e,e,g,g,g,g,g,g,g,g,g,g,r,r,w,w,w,w,w,w,w,w,w,w,w,w,w,w,w,w,w,w,w,w,w,w,w,w,w,w,w,w,w,w,w,
T,T,T,T,T,T,T,T,T,T,T,T,T,T,T,T,T,T,T,T,T,t,T,t,T,t,t,T,T,t,t,t,t,t,t,t,t,t,t,t,t,t,r,r,w,w,w,w,w,w,w,w,w,w,w,w,w,w,w,w,w,w,w,w,w,w,w,w,w,w,w,w,w,w,w,