music=midi2.mid
30,30,1,4,0,
e,Map5,40,9,none,
e,3,3000;monster.penguin,
e,10,4000;monster.penguin,
e,2,4000;monster.penguin,
e,2,3000;monster.penguin,
water,
w,w,w,w,w,w,w,w,w,w,w,w,w,w,w,w,w,w,w,w,w,w,w,w,w,w,w,w,w,w,
w,w,w,w,w,w,w,w,w,w,w,w,w,w,w,w,w,w,w,w,w,w,w,w,w,w,w,w,w,w,
w,w,w,w,w,w,w,w,w,w,w,w,w,w,w,w,w,w,w,w,w,w,w,w,w,w,w,w,w,w,
w,w,w,w,w,w,w,w,w,w,w,w,w,w,w,w,w,w,w,w,w,w,w,w,w,w,w,w,w,w,
w,w,w,w,w,w,w,w,w,w,w,w,w,w,E,E,E,E,E,w,w,w,w,w,w,w,w,w,w,w,
w,w,w,w,w,w,w,w,w,w,E,E,E,E,E,e,e,e,e,E,w,w,w,w,w,w,w,w,w,w,
w,w,w,w,w,w,w,w,E,E,e,e,e,e,e,e,e,e,e,e,E,w,w,w,w,w,w,w,w,w,
w,w,w,w,w,w,E,E,e,e,e,e,e,e,e,e,e,c,e,e,E,w,w,w,w,w,w,w,w,w,
w,w,w,w,w,E,e,e,e,e,e,e,e,e,e,e,e,e,e,e,E,w,w,w,w,w,w,w,w,w,
w,w,w,w,E,e,e,e,e,e,e,e,e,e,e,e,e,e,e,e,E,E,w,w,w,w,w,w,w,w,
w,w,w,E,e,e,e,e,e,e,e,e,e,e,e,e,e,e,e,e,e,E,w,w,w,w,w,w,w,w,
w,w,w,E,e,e,e,c,e,e,e,e,e,e,e,e,e,e,e,e,e,E,w,w,w,w,w,w,w,w,
w,w,w,E,e,e,e,e,e,e,e,e,e,e,e,e,e,e,e,e,e,E,E,w,w,w,w,w,w,w,
w,w,w,E,e,e,e,e,e,e,e,e,e,c,e,e,e,e,e,e,e,e,E,E,w,w,w,w,w,w,
w,w,w,w,E,e,e,e,e,e,e,e,e,e,e,e,e,e,e,e,e,e,e,E,w,w,w,w,w,w,
w,w,w,w,E,e,e,e,e,e,e,e,e,e,e,e,e,e,e,e,e,e,e,E,w,w,w,w,w,w,
w,w,w,w,E,e,e,e,e,e,e,e,e,e,e,e,e,e,e,e,e,e,e,E,w,w,w,w,w,w,
w,w,w,w,w,E,e,e,e,e,e,e,e,e,e,e,e,e,e,e,e,e,e,e,E,w,w,w,w,w,
w,w,w,w,w,w,E,E,E,e,e,e,E,E,E,E,E,E,e,e,e,e,e,e,E,w,w,w,w,w,
w,w,w,w,w,w,w,w,w,e,E,E,w,w,w,w,w,E,e,e,e,c,e,e,E,w,w,w,w,w,
w,w,w,w,w,w,w,w,e,e,w,w,w,w,w,w,w,w,E,E,e,e,e,e,E,w,w,w,w,w,
w,w,w,w,w,w,w,w,e,w,w,w,w,w,w,w,w,w,w,w,E,e,e,e,E,w,w,w,w,w,
w,w,w,w,w,w,w,w,e,w,w,w,w,w,w,w,w,w,w,w,w,E,E,E,w,w,w,w,w,w,
w,w,w,w,w,w,w,w,e,w,w,w,w,w,w,w,w,w,w,w,w,w,w,w,w,w,w,w,w,w,
w,w,w,w,w,w,e,e,e,w,w,w,w,w,w,w,w,w,w,w,w,w,w,w,w,w,w,w,w,w,
w,w,w,w,w,w,e,w,w,w,w,w,w,w,w,w,w,w,w,w,w,w,w,w,w,w,w,w,w,w,
w,w,w,w,w,w,e,w,w,w,w,w,w,w,w,w,w,w,w,w,w,w,w,w,w,w,w,w,w,w,
w,w,w,w,w,w,e,w,w,w,w,w,w,w,w,w,w,w,w,w,w,w,w,w,w,w,w,w,w,w,
w,w,w,w,w,e,e,w,w,w,w,w,w,w,w,w,w,w,w,w,w,w,w,w,w,w,w,w,w,w,
w,w,w,w,w,m,w,w,w,w,w,w,w,w,w,w,w,w,w,w,w,w,w,w,w,w,w,w,w,w,