music=midi1.mid
12,14,1,2,0,
e,test2,1,1,none,
g,5;monster.blueGreen,monster.red,
g,5;passive.passive,monster.counter,
e,e,e,e,e,g,e,e,e,e,e,e,e,e,
e,e,e,e,g,g,g,e,e,r,e,e,g,g,
e,c,e,g,g,g,g,g,e,m,e,e,g,g,
e,e,g,g,g,w,g,g,g,e,e,e,g,g,
e,g,g,g,w,w,w,g,g,g,e,e,g,g,
g,g,g,w,w,w,w,w,g,g,g,e,g,g,
e,g,g,g,w,w,w,g,g,g,e,e,g,g,
e,e,g,g,g,w,g,g,g,e,e,e,g,g,
e,e,e,g,g,g,g,g,e,e,e,e,g,g,
e,t,e,e,g,g,g,e,e,e,e,g,g,g,
e,e,e,e,e,g,e,e,e,e,g,g,c,g,
e,e,e,e,e,e,e,e,e,g,g,g,g,g,
