music=midi2.mid
18,14,1,2,0,
g,test,3,3,none,
g,5;monster.penguin,
g,5;monster.blueGreen,
e,e,e,e,e,g,e,e,e,e,e,e,e,e,
e,e,e,e,g,g,g,e,e,r,e,e,c,g,
e,e,e,g,g,g,g,g,e,e,e,e,g,g,
e,e,g,g,g,w,g,g,g,e,e,e,g,g,
e,g,g,g,w,w,w,g,g,g,e,e,g,g,
g,g,g,w,w,w,w,w,g,g,g,e,g,g,
e,g,g,g,w,w,w,g,g,g,e,e,g,g,
e,e,g,g,g,w,g,g,g,e,e,e,g,g,
e,e,e,g,g,g,g,g,e,e,e,e,g,g,
e,t,e,e,g,g,g,e,e,e,e,g,g,g,
e,e,e,e,e,g,g,e,e,e,g,g,g,g,
w,w,e,e,e,g,g,g,e,g,g,m,g,g,
w,w,w,w,g,g,g,g,g,g,g,g,g,g,
w,w,w,w,w,g,g,g,e,g,g,g,g,g,
w,w,w,w,w,g,g,g,e,e,g,g,g,g,
w,w,w,w,g,g,g,g,e,g,g,g,g,g,
w,w,g,g,g,g,g,c,g,g,g,g,e,g,
g,g,g,g,g,g,g,g,g,g,g,g,g,g,